pro	PRP
phon	SKIP
uni	SKIP
pro:per	PRP
v	VB
inf	IN
det:art	DT
n	NN
prep	IN
v	VB
adj	JJ
mod	VB
pro:obj	PRP
pro:int	PRP
pro:dem	PRP
co	SKIP
aux	VB
on	SKIP
coord	SKIP
det:num	DT
qn	RB
pro:sub	PRP
adv	RB
cop	VB
n:prop	NN
pro:indef	PRP
cm	SKIP
det:poss	DT
adv:int	RB
adv:wh	RB
neg	RB
pro:refl	PRP
part	VB
pro:rel	SKIP
conj	RB
n:pt	SKIP
det:dem	DT
adv:tem	RB
n:gerund	JJ
un#v	VB
n:let	SKIP
in#adj	JJ
fam	NN
det:int	DT
mod:aux	VB
post	RB
pro:poss	PRP
pro:poss:det	DT
adj:part	JJ
det:wh	DT
meta	SKIP
bq	SKIP
eq	SKIP
chi	SKIP
grand#n	NN
pro:exist	SKIP
un#part	VB
un#n	VB
un#n:gerund	VB
non#adj	JJ
wplay	SKIP
0pro	PRP
under#v	SKIP
un#adj	JJ
co#v	VB
0det	DT
L2	SKIP
neo	SKIP
bi#n	NN
dis#part	VB
co#n	NN
mis#part	VB
0v	SKIP
beg	SKIP
end	SKIP
under#n	NN
sub#n	NN
n:adj	JJ
bab	SKIP
in#n	SKIP
test	SKIP
out#v	VB
0prep	IN
dis#n:gerund	VB
pre#part	SKIP
